安徽省 - 迎客松
江苏省 - 大闸蟹
浙江省 - 雷峰塔
福建省 - 土楼
广东省 - 早茶
广西壮族自治区 - 荷花??
云南省 - 大象
西藏自治区 - 布达拉宫
新疆维吾尔族自治区 - 毡房
甘肃省 - 猴子??
内蒙古自治区 - 驯鹿
黑龙江省 - 雪人
吉林省 - ??
辽宁省 - 梅花鹿
河北省 - ??
北京市 - 故宫
天津市 - ??
山东省 - 苹果
河南省 - 佛祖
湖北省 - 天鹅
江西省 - 瓷器
湖南省 - 臭豆腐
贵州省 - 山水
四川省 - 熊猫
青海省 - 骆驼
宁夏回族自治区
陕西省 - 大雁塔
山西省 - 陈醋
重庆直辖市 - 火锅
海南省 - 椰子
台湾省 - ??